|-------------------------------------------------------| 
|                                                       | 
######################################################### 
#     %       $                                         # 
#########################################   ############# 
#                                                       # 
######################   ################################ 
#                          $                            # 
#########################################   ############# 
#                      &                                # 
####################################   ################## 
#                                                       # 
##############################################   ######## 
#                                                       # 
#############   ######################################### 
#                                                       # 
############################   ########################## 
#            &                                   $      # 
########   ############################################## 
#                                                       # 
###############   ####################################### 
#             &                                    $    # 
####################################   ################## 
#                  $                                    # 
######################################################### 